11111111111111111111111111111111111111111111111111
1                                               31
1                                            11111
1                        s               111111111
11111111111111111111111111111111111111111111111111
