11111111111111111111111111111111111111111111111111
1                                               51
1                                            11111
1                                        111111111
11111111111111111111111111111111111111111111111111
